R  300  300


NO srcs/img/no.xpm


SO srcs/img/so.xpm


WE srcs/img/we.xpm



EA srcs/img/ea.xpm


S srcs/img/srt.xpm

F  56,10,30


C  248,142,148



        111111111111111111111111
        1000000010000000000000W11
 11111111000000222200000000000001
 1000000000010000000000001111111
 100000000000000011111111
 100000000000000000000001
 10000000000000000111111
 100011111000011111111
 1001     100001
 1111     111111
 