R  1200  600


NO srcs/img/no.xpm


SO srcs/img/so.xpm


WE srcs/img/we.xpm



EA srcs/img/ea.xpm


S srcs/img/srt.xpm

F  56,10,30


C  248,142,148



        111111111111111111111111
        1000000010000000000000W11
1111111100000022220000000000000001
110000000000100000000000011111111
100000000000000001111111111
1000000000000000000000001
100000000000000000111111
1000011111000011111111
10011    100001
1111     111111
 