R  2500  1439


NO srcs/img/no.xpm


SO srcs/img/so.xpm


WE srcs/img/we.xpm



EA srcs/img/ea.xpm


S srcs/img/srt.xpm

F        56,0,3


C       104,24,0



1111111111111111111111111
1000000010000000000000011
10000002222222222222200W1
1000000000010000000000001
100000000000000011111111
10000000000000000000001
1000000000000000011111
100011111000011111111
1001     100001
1111     111111
