R  2000  1400


NO srcs/img/no.xpm


SO srcs/img/so.xpm



WE srcs/img/we.xpm



EA srcs/img/ea.xpm


S srcs/img/srt.xpm

F        56,0,3


C       104,24,0



11111111111111111111111
100000201000000000000001
1000000001000100000000001
1000000000010000200000001
100000000000000011111111
10000000000000000000201
120000W000020000011111
100011111000011111111
1001     100001
1111     111111
